111111111111111111111111111111
1EP00000000000000000X00X000C01
111111111111111011111111111111
1C0X000000000000000000000000C1
111111111111111111111101111111
1C0000000000X00000000X000000C1
111111111101111111111111111111
1C000000X00000000X0000000000C1
111111111111111101111111111111
111111111111111101111111111111
111111111111111101111111111111
111111111111111101111111111111
111111111111111101111111111111
111111111111111101111111111111
1111111111111111C1111111111111
111111111111111111111111111111